bing=丙-並
bu=不
cheng=丞
chou=丑-丒
cong=丛
ding=丁
diu=丟
dong=东
gai=丐
ji=丌
kao=丂
li=丽
liang=両-两-兩
mian=丏
pi=丕
qi=七
qie=且
qiu=丠
san=三
sang=丧
shang=丄-上
shi=世-丗
si=丝
wan=万
wu=无
xia=丅-下
ya=襾
yan=严
ye=业
yi=一
you=丣
yu=与
zhang=丈
zhuan=专
unknown=丆
