cai=才
cao=艹
cha=叉
che=屮
chi=彳
chu=亍
chuan=巛-川
chuo=辶
cun=寸
da=大
fan=凡-凢-凣
fei=飞
fu=阝
gan=干
ge=个
gong=工-廾-弓
guang=广
gui=巜
ji=丌-亼-及-己-彐-彑
jie=卪-孑
jin=巾
jiu=久-乆
jue=孒-孓
kou=口
kui=亏
ma=马
me=么
men=门
mi=纟
mian=宀
nian=卄
nu:=女
qi=乞
qian=千
qiang=丬
quan=犭
ren=刃-刄
san=三
shan=山-彡
shang=上
shao=勺
shi=士-尸-饣
shou=扌
shui=氵
si=巳
sui=夊
tu=土
tuo=乇
wan=万-丸
wang=亡-亾-兦-尢-尣
wei=卫-囗
wu=兀
xi=习-夕
xia=下
xiang=乡
xiao=小
xin=卂-忄
ya=丫-劜
yao=幺
ye=也
yi=义-亿-已-弋
yin=廴
yu=与-于-亐
ze=夨
zhang=丈
zhi=之-夂
zi=子
unknown=乊-亇-亽
