bao=靌
biao=飍
bie=龞
chou=犫
dang=讜
du=黷
e=鱷
fei=飝
feng=飌
gan=灨
he=靎-鸖
huan=驩
ji=驥
jie=蠽
jiu=鬮
ju=驧
jue=躩
lan=糷-纜
lei=纝-虆
li=靋
lin=躪-轥
long=鸗
lu=鱸-鸕
luan=鑾
luo=鑼-饠
nie=顳
nong=齈
pan=鑻
peng=驡
qu=貜
quan=灥-虇-顴
rang=鬤
shuang=驦
xiang=驤
xiao=虈
xing=馫
yan=灧-讞-豓-釅
yi=虉
yu=軉-鬰
zao=鑿
zha=蠿
zhan=讝
zhu=蠾
zuan=鑽-饡
unknown=靍
