ai=靉
ba=欛
bi=鼊
bian=籩
bie=鼈
bo=鑮
cang=鑶
chan=鑱-饞
chang=鱨
chi=齹
chu=曯
cuan=躥
dan=黵
dao=纛
di=鸐
dian=齻
dou=鬬
gang=戅-戆
guan=觀-鑵
hong=黌
hu=鸌
huai=蘹-蘾
huan=讙-貛
huo=彠-讗-鱯
ji=蘻-虀-覊-鱭
jian=襺-鑯-鑳-韉
jiao=釂
jie=躤
jue=矡-龣
kan=矙
kuan=髖
kui=犪
lan=欖-欗-爤-爦-鑭-顲
lei=欙-蘱-蘽
li=欚-籬-蘺-鱱
lie=鬣
long=鑨
lu=顱-髗
luan=臠
luo=籮-纙-蘿
man=蠻
meng=鸏
mi=蘼-鸍
mie=鱴
mo=饝
nang=囔-攮-灢-馕
nao=虁
ni=臡
nie=躡
ning=鸋
pan=襻
qi=麡
qu=躣
ru=鱬
shai=籭
shi=襹
ta=躢
tang=矘
teng=鼟
tiao=糶
ting=廳
tuo=鼉
wan=灣
xi=纚-觿
xiang=鑲-饟-鱶
xin=釁
xu=鱮
yan=礹
yao=鑰
yi=襼-讛-齸
ying=鸎
yu=欝-鸒
yuan=鼝
yue=鸑
zan=襸
zang=贜
zha=齇
zhan=蘸
zhe=讘
zhi=豒
zhu=斸-欘-爥
zou=齺
zuan=籫-纘
unknown=囕-壪-襽-鱰
