bi=鼊
bie=虌
bo=鸔
cang=鑶
chan=饞
cuan=鑹
die=氎
dou=鬭
feng=靊-飌
guan=鑵
huo=彠
ji=驥
jian=虃-韉
jiu=鬮
lan=糷
lei=鑸-鸓
li=鱱-鱳
lie=鱲
lin=躪-轥
lu=虂-髗
lu:=驢
luan=圞-灤-虊
luo=癳
mi=釄
mie=鱴
nang=欜
nie=鑷
peng=驡
qu=蠼-鑺
quan=顴
shi=釃
shu=虪
teng=驣
xi=矖-躧-鑴
xian=灦
xiang=饟-鱶
xie=龤
xin=釁
yan=灎-釅-驠-黶
yi=讛
ying=籯
yu=欝
yue=籰-龥
zan=讚-趲
zhan=讝
zhen=鱵
zhu=矚
zuan=躦
zuo=糳
unknown=虄-虅
