ba=八
bao=勹
bi=匕
bing=冫
bu=卜
chang=厂
dao=刀-刂
diao=刁
ding=丁
er=二-儿
fang=匚
fu=阝
gui=巜
ji=几
jie=卩
jiong=冂
jiu=丩-九
kao=丂
le=了
li=力
mi=冖
mie=乜
nai=乃
qi=七
qu=凵
ren=人-亻
ru=入
shang=丄
shi=十
si=厶
tou=亠
xi=匸
xia=丅
yan=讠
yi=乂
yin=廴
you=又
unknown=丆-丷-乄
