ban=办
bo=勃
bu=勏
che=勶
chi=勅
dan=勯
dong=动-動
fan=勫
gong=功
hao=勂
he=劾
ji=勣
jia=加
jiao=勦
jie=劫-劼
jing=劤-劲-勁
ju=勮
juan=劵-勌-勬
kai=勓
kan=勘
ke=勀-勊
keng=劥
kou=劶
kuang=劻
lai=勑
lang=勆
lao=劳-労-勞
le=勒
li=力-励-勵
lie=劣-劽
lu=勎-勠
lu:=勴
mai=劢-勱
meng=勐
mian=勉-勔
min=勄
mo=劰
mou=劺
mu=募
nu=努
piao=勡
qiang=勥
qiao=勪
qin=勤
qing=勍
qu=劬
quan=劝-勧-勸
rang=勷
shao=劭
sheng=勝
shi=势-勢
tong=勭
wa=劸
weng=勜
wu=务-務
xiang=勨
xiao=効
xie=劦-勰
xu=勖-勗
xun=勋-勛-勲-勳
ya=劜
yang=劷
yi=劮-勚-勩
yong=勇-勈
zhi=劧
zhu=助-劯
