an=厈
ao=厫
ce=厕-厠
chang=兏-厂-厰
chu=厨
cuo=厝
dian=厧
e=厄
fei=厞
gui=厬
han=厃
hou=厚
jiu=厩
jue=厥
ke=厒
lan=厱
li=历-厉-厘-厤-厯-厲
pang=厐-厖
qin=厪
sha=厦
she=厍-厙
si=厮
ti=厗
ting=厅-厛
xiang=厢
ya=厊-压-厓
yan=厌-厣-厭-厳-厴
yuan=原-厡-厵
zha=厏
zhe=厇
zhi=厎-厔
zui=厜
unknown=厑
