ba=弝
beng=弸
bi=弻-弼-彃
bie=彆
chao=弨
chi=弛
dan=弹-弾-彈
di=弟-弤
diao=弔-弴
fa=彂
fu=弗-弣
gong=弓
gou=彀
hong=弘-彋
hu=弖-弧
jian=弿
jiang=弶
jing=弪-弳
jue=弡-彏
kou=彄
kuang=彉
kuo=彍
mi=弥-弭-彌
nu=弩
qiang=弜-強-强-彊
quan=弮
ruo=弱
shao=弰
she=弽
shen=弞
tao=弢
tui=弚
wan=弯-彎
wu=弙
xian=弦
xiao=彇
xuan=弲
yi=弬
yin=引
zhang=张-張
zhen=弫
unknown=彁-彅
