bao=忁
bi=彼
bian=徧
bie=徶
chang=徜
che=彻-徹
cheng=徎
chi=彳-徥-徲
chong=徸
cong=従-徖-從
cu=徂
dai=待
de=得-徳-德
di=彽
fu=彿-復
hen=很
hou=後
huai=徊
huang=徨
hui=徽
ji=彶
jia=徦
jian=徤
jiao=徺-徼
jie=徣
jing=径-徑
lai=徕-徠
ling=彾
long=徿
lu:=律
mei=徾
pai=徘
pang=彷-徬
piao=徱
qi=徛
qu=忂
tu=徒
tuo=彵
wang=彺-往-徃-徍
wei=徫-微-徻
xi=徆-徙-徯
xiang=忀
xie=徢
xu=徐
xun=徇-循
yang=徉
yao=徭
yi=役
yu=御
zheng=征-徰-徴
zhi=徏-徝-徵
zhong=彸
zhou=徟
zhuo=彴
unknown=徔-徚
