cai=戝
cheng=成
chuang=戧
chuo=戳
dai=戴
deng=戥
die=戜
dong=戙
gai=戤
ge=戈-戓-戨
huo=或
ji=戟-戢
jia=戛-戞
jian=戋-戔-戩-戬
jie=戒-截
kan=戡
kui=戣
lu=戮
qi=戚
qiang=戕-戗
qu=戵
rong=戎
shi=戠
shu=戍
wo=我
wu=戊
xi=戏-戯-戱-戲
xu=戌
yan=戭
yu=戫
yue=戉
zhan=战-戦-戰
