ao=摮
bai=拜-掰
bo=擘
che=掣
cheng=承
chi=摰
dun=撉
ge=搿
gong=拲
gou=撀
ji=撃-擊
jiu=揫
ju=挙-擧
la=揧
lan=擥
luan=挛-攣
mo=摩-摹
na=拏-拿
nuo=搻
pan=搫-攀
pie=撆
qian=掔-搴
qie=挈
qing=擎
quan=拳
ru=挐
shou=手-掱
shuo=揱
suo=挲
yan=揅
ye=擪
zhang=掌
zhi=挚-摯
