bin=殡-殯
can=残-殘
chou=殠
cu=殂-殧
cuan=殩
dai=歹-殆
dan=殚-殫
diao=殦
du=殬-殰
fou=殕
hui=殨
hun=殙
ji=殛
jian=歼-殱-殲
jiang=殭
jin=殣
jue=殌
lian=殓-殮
mo=歾-歿-殁
piao=殍
qia=殎
qing=殑
qiu=殏
shang=殇-殤
sheng=殅
shu=殊
si=死
su=殐
ti=殢
tian=殄
wen=殟
xu=殈
xun=殉
yang=殃
yao=殀
ye=殗-殜
yi=殔-殪
yin=殥
yun=殒-殞
zhe=歽
zhi=殖
unknown=殝
