bi=毴-笔
chang=氅
cui=毳
die=氎
dou=毭
duo=毲
er=毦
hao=毫
he=毼
jia=毠
jian=毽
ju=毩-毱
li=氂
lu=氇-氌
lu:=氀
mao=毛-毷
meng=氋
mu=毣-毪-氁
pei=毰
pi=毞
pu=氆
qiu=毬
qu=氍
rong=毧-氄
sai=毢
san=毵-毿
sao=氉
shu=毹
sui=毸
ta=毾
tan=毯
tong=氃
tuo=毤-毻
xian=毨
xun=毥
yu=毺
zhan=毡-氈-氊
unknown=毜-毝-毟-毮-毶
