ban=瓪
beng=甏
bian=甂
bu=瓿
chang=瓺
chi=瓻
chui=甀
ci=瓷-甆
dan=瓭-甔
dang=瓽
di=甋
fang=瓬
hu=瓳
jiang=瓨
juan=瓹
lin=甐
ling=瓴
lou=甊
meng=瓾-甍
ou=瓯-甌
pen=瓫
pi=甓
ping=瓶-甁
qi=甈
qian=瓩
wa=瓦
weng=瓮-甕
wu=甒
xian=甉
yan=甗
yi=瓵
ying=甇-甖
zeng=甑
zhen=甄
zhou=甃
zhuan=甎
unknown=瓧-瓰-瓱-瓲-瓸-瓼-甅
