ben=畚
bi=畀-畢
bo=疈
ce=畟
cha=疀
chang=畅-畼
cheng=畻
chou=畴-疇
chu=畜
chuo=畷
da=畗-畣
dang=當
dian=电-甸
die=畳-疂-疉-疊
ding=町
fan=畈-番
fu=甶-畉-畐
gai=畡
geng=畊
hua=画-畫-畵
ji=畸-畿
jia=甲
jiang=畕-畺-疅-疆
jie=界-畍
jun=畯
lei=畾
lin=疄
liu=畂-畄-留-畱-疁
lu:e=略-畧
meng=甿
mu=畆-畒-畝-畞-畮
nan=男-畘
pan=畔-畨
ping=甹
qi=畁-畦
quan=甽-畎
she=畲
shen=申
tian=田-畋-畑
ting=甼
tuan=疃
tun=畽
wa=畖
wan=畹
wei=畏
xun=畃
yi=異
you=由
yu=畬-畭-禺
yun=畇
zai=甾
zha=甴
zhen=畛
zhi=畤
unknown=畓-畠-畩
