an=盦-盫
ang=盎
bei=盃
bo=盋
dang=盪
dao=盗-盜
fan=盕
fu=盙-簠
gai=盖
gu=盬
guan=盥
gui=簋
he=盇-盉-盍-盒
jian=监-監
jin=盡
kui=盔
li=盭
lu=盝-盠-盧
meng=盟
min=皿
pan=盘-盤
pen=盆
qi=盀
qiu=盚
sheng=盛
wan=盌
xu=盢-盨
yan=盐
yi=益
ying=盁-盈
yu=盂-盓
zhan=盏-盞
zhao=盄
zhong=盅
zhou=盩
