bao=窇
bian=窆
bing=窉
cheng=窚-竀
chuan=穿-窓
chuang=窗-窻
cuan=窜-竄
cui=竁
dan=窞
diao=窎-窵
dou=窦-竇
gui=窐
jiao=窌-窖
jing=穽
jiong=窘
jiu=究
ju=窭-窶-窼
ke=窠
kong=空
kou=窛
ku=窟
kuan=窾
kui=窥-窺
lao=窂
liao=窲-窷
long=窿
piao=竂
qiao=窍-竅
qie=窃-竊
qiong=穷-穹-窮-竆
sen=穼
su=窣
tian=窴
tiao=窕-窱
tu=突
wa=穵-窪
wo=窝-窩
wu=窏-窹
xi=穸-窸
xiao=窙
xu=窢
xue=穴
ya=窫
yao=穾-窅-窈-窑-窔-窯-窰
yin=窨
yu=穻-窊-窬-窳
zao=竃-竈-竉
zhai=窄
zhi=窒
zhu=窋
zhui=窡
zhun=窀
unknown=窤-窧-窽
