ao=聱
bi=聛
che=聅
chi=耻
cong=聡-聦-聪-聰
da=耷
dan=耼-耽-聃-聸
di=聜
die=聑
ding=耵
er=耳-聏
geng=耿
guo=聒-聝
hao=聕
hong=耾
ji=聻
jing=聙
ju=聚
kui=聧-聩-聭-聵
lian=联-聨-聫-聮-聯
liao=聊
lie=聗
ling=聆
long=聋-聾
nie=聂-聶
ning=聍-聹
pin=聘
ping=聠
qin=耹
sheng=聖-聲
song=耸-聳
tiao=聎
ting=聤-聴-聼-聽
wa=聉
wen=聞
weng=聬
xu=聟
ya=聐
ye=耶
you=聈
yu=聥
yun=耺
zhe=耴
zhen=聄
zheng=聇
zhi=聀-职-職
unknown=聁-聓-聢-聣-聺
