bi=觱
chao=觘
chu=触-觸
cu=觕
dan=觛
di=觝
ge=觡
gong=觥-觵
gu=觚
gui=觤
hu=觳
hua=觟
huan=觨
ji=觙-觭
jiao=角
jie=解-觧
jin=觔
jiu=觓
jue=觖-觼
li=觻
lu=觮
ni=觬
qiu=觩
quan=觠
shang=觞-觴
su=觫
xi=觹-觽-觿
xing=觪-觲
xue=觷
yan=觾
yi=觺
zhi=觗-觢-觯-觶
zhu=觰
zui=觜
