an=貋
bao=豹
bi=貏
chai=豺
chu=貙
diao=貂
duo=貀
e=貖
gou=豿
han=豻
he=貈-貉
huan=貆-貛
jia=貑
ju=貗
kun=貇
li=貍
mao=貌-貓
mo=貃-貊-貘
na=豽
ni=貎
pi=豼-豾-貔
qu=貜
si=貄
tan=貚
tuan=貒
xi=貕
xiu=貅
you=貁
yu=貐
zhi=豸
