ai=賹
bai=贁
bao=賲
bei=貝
bi=貱-賁-贔
bian=貶
biao=贆
bin=賓-賔
cai=財
cang=賶
chen=賝-贂
chi=貾
chuan=賗
cong=賨-賩
dai=貸
dan=賧
du=賭-贕
er=貮-貳
fan=販
fei=費
feng=賵
fu=負-賦-賻
gai=賅-賌
gan=贑-贛
geng=賡
gong=貢
gou=購
guan=貫
gui=貴
hang=貥
he=賀
hui=賄
huo=貨
ji=賫-賷
jia=賈
jian=賎-賤
jiao=賋
jin=賮-贐
kuang=貺
lai=賚-賴
liao=賿
lin=賃
long=贚
lu=賂
mai=買-賣
mao=貿
pei=賠
pian=貵-賆
pin=貧
qiu=賕
sai=賽
shan=贍
shang=賞
she=賒-賖
sheng=貹-賸
shi=貰
shu=贖
shun=賰
si=賜
sui=賥
tan=貪-贉
te=貣
tian=賟
tie=貼
wan=貦-贎
wei=贀
xian=賢-贒
xiong=賯
xu=賉
xuan=贙
xun=賐
yan=贋-贗
yi=貤-貽
ying=賏-贏
yuan=貟
yun=賱-贇
zai=賳
zan=賛-贊
zang=賍-賘-贓-贜
ze=簀-責-賾
zei=賊
zeng=贈
zhang=賬
zhen=貞-賑
zhi=筫-貭-質-贄
zhou=賙
zhu=貯
zhuan=賺-贃
zhui=贅
zi=貲-資
unknown=贌-贘
