chao=超
chen=趁-趂
chi=赿-趍-趩
chu=趎
chuo=趠
ci=赼-趀
cu=趗
cui=趡
dang=趤
di=趆
die=趃
duo=趓
fu=赴
gan=赶-趕
gua=趏
huang=趪
jian=趝
jie=趌
jiu=赳
ju=趄-趜
jue=赽
li=赲
lie=趔
lu=趢
qi=起
qiao=趫-趬
qin=赺-赾
qiong=赹
qiu=趥
qu=趋-趣-趨
que=趞
se=趇
shan=赸
su=趚
suo=趖
tang=趟
ti=趧
tiao=趒
xi=趘
xian=赻
xue=趐
yao=趭
yin=趛
yue=越-趯
zan=趱-趲
zao=趮
zhan=趈
zhao=赵-趙
zhu=趉
zi=趑-趦
zou=走
unknown=趰
