ang=軮
ao=軪
ba=軷
bei=軰-輩
ben=輽
chao=轈
che=車-轍
chen=軙
chuan=輲
chun=輴
chuo=輟
cou=輳
dai=軚-軩
di=軑-軧
dui=轛
e=軛-軶
er=輀-轜
fan=軓-軬-轓
fen=轒
fu=輔-輹-輻
ge=輵-轕
gu=軱-軲-轂
guan=輨
guang=輄
gui=軌
gun=輥
guo=輠
hong=軣-輷-轟
hu=軤
huan=輐-轘
huang=軦
hui=輝
hun=轋
ji=輯-轚
jiao=較-轎
jiu=轇
ju=輂-輋
jun=軍
kai=輆
kan=輡-轗
ke=軻
kuang=軭
lao=轑
lei=轠
li=轢-轣
liang=輌-輛-輬
lin=轔-轥
ling=軨-輘
lu=輅-轆-轤
lun=輪
mao=軞
na=軜
ni=輗
nian=輦
pai=輫
pao=軳
pei=轡
peng=軯-輣
ping=軿-輧
pu=轐
qi=軝
qian=軡-輤
qiang=軖
qing=軽-輕
qiong=輁
qu=軥
quan=輇
ren=軔-軠
rong=軵
rou=輮
ruan=軟-輭
se=轖
shan=軕
shao=輎
shi=軾
shu=軗-輸
tao=轁
tun=軘
wan=輓
wang=輞
wei=軎-轊
wen=輼-轀
xia=轄
xian=輱-轞
xin=軐
xuan=軒
ya=軋
yang=輰
yao=軺
yi=軼-輢-轙
you=輏-輶
yu=輍-輿-轝
yuan=轅
yue=軏
yun=輑
zai=載
zhan=輚-輾-轏
zhe=輒-輙
zhen=軫-轃
zhi=軹-輊
zhou=軸-輈-輖
zhu=軴
zhuan=転-轉
zi=輜-輺
unknown=轌
