ang=醠
bu=醭
cheng=酲
chou=酧-酬-醜-醻
chun=醇-醕
chuo=酫-醊
cu=醋
cuo=醝
dai=酨
dan=酖
ding=酊
du=醏
fa=酦-醗-醱
fen=酚
gan=酐
gu=酤
hai=酼-醢
han=酣
hu=醐
jiang=酱-醤-醬
jiao=酵-醮-釂
jiu=酒
ju=醵
ke=醘
ku=酷
kun=醌
lan=醂
lao=酪-醦-醪
lei=酹
li=醨-醴
ling=醽
lu=醁
mao=酕
mei=酶
mi=醚-醾-醿-釄
ming=酩
niang=酿-醸-釀
nong=醲
pei=配-醅
piao=醥
pu=酺
qia=酠
qiu=酋-醔
quan=醛
ru=醹
shi=酾-釃
sou=醙
su=酥
suan=酸
tai=酞
tan=醈-醓-醰
tang=醣
tao=醄
ti=醍
tian=酟
tong=酮
tou=酘
tu=酴
tuo=酡
wei=醀
xi=醯
xian=酰-醎
xin=釁
xing=醒
xu=酗-醑
xun=醺
yan=酓-酽-醃-醶-醼-釅
yi=酏-醫-醳-醷
yin=酳
yong=醟
you=酉-酭
yu=酑-醧
yun=酝-醖-醞
zao=醩
zha=醡
zhan=醆
zhen=酙
zhi=酯
zhou=酎
zhuo=酌
zui=酔-酻-醉
zuo=酢
unknown=酛-酜
