ao=鏊-鏖
bei=錃-鐾
chi=銐
du=錖
dui=鐜
fu=釜
hong=鍙
jian=鉴-鋻-鍳-鑒
jin=金
jun=銞
li=鋫-錅
liu=鎏
long=鏧
luan=銮-鑾
mou=鍪
pan=鎜
pie=鐅
qiao=鍫
qing=鑋
qiong=銎
shi=銴-鋬
sui=鐆
tiao=鋚-鎥
wu=鋈
xian=鍌
xin=鑫
ying=鎣-鑍
yun=鋆
zan=錾-鏨
zang=銺
zao=鑿
zhen=錱
zi=鈭
unknown=鐢
