an=闇
ban=闆
beng=閍
bi=閇-閉-閟
bian=閞
chan=閳-闡
chang=閶
chu=閦
chuang=闖
da=闒
dang=闣
dou=閗-闘
du=闍
e=閼
fa=閥
ge=閣
guan=関-闗-關
gui=閨
han=閈
he=閡-閤-闔
hong=閎-閧
huan=闤
hui=闠
hun=閽
huo=閄
jian=間
kai=開-闓
kan=闞
kang=閌
ke=閜
kui=闚
kun=閫-閸
kuo=闊
lan=闌
lang=閬
lin=閵
ling=閝
lu:=閭
ma=閁
men=門-閅
min=閔-閖-閩-閺
nao=閙
nie=闑
peng=閛
pi=闢
piao=闝
qi=闙
qu=閴-闃
que=闋-闕
run=閏-閠
san=閐
sha=閯
shai=閷
shan=閃
shuan=閂
ta=闥
tang=闛
tian=闐
ting=閮
wei=闈
wen=閿-闅-闦
xi=闟
xia=閕
xian=閑-閒
xiang=闀-闂
yan=閆-閰-閹-閻
yao=闄
yin=闉
yu=閾
yue=閱-閲
zha=閘
unknown=閊-閚-閪-闁-闎-闏-闧
