chou=雔-雠
chu=雏-雛
ci=雌
diao=雕
gou=雊
gu=雇
guan=雚
han=雗
he=隺
hu=雐
huan=雈
huo=雘
ji=集-雞-雦-雧
ju=雎
juan=隽
jun=雋
li=離
liu=雡
luo=雒
nan=难-難
qin=雂
que=雀
shuang=雙
sui=雖-雟
sun=隼
xiong=雄
xue=雤
ya=雃-雅
yan=雁
yi=隿
yong=雍-雝
yu=雓
za=雑-雜-雥
zhi=隻-雉
zhui=隹
