ai=霭-靄-靉
an=雸
ba=霸
bao=雹-靌
bin=霦
bing=靐
chen=霃
chou=霌-霔
dai=霴-靆
dan=霮
dang=雼
deng=霯
dian=電
dong=霘
fei=霏-靅
fen=雰
feng=靊
fou=雬
hang=雽
he=靎-靏
hong=霟
huo=霍-靃
ji=霁-霵-霽
kuo=霩
lei=雷-靁
li=雳-雴-靂-靋
lin=霖
ling=零-霊-霛-霝-靈
liu=霤
long=霳-靇
lu=露
mai=霡-霾
mei=霉
meng=雺-霥-霿-靀
mo=霢
mu=雮-霂
na=雫
ni=霓
pang=雱-霶
pei=霈
pi=霹
qi=霋
se=雭
sha=霎
shuang=霜
ting=霆
tun=霕
wei=霨-霺
wen=雯
weng=霐
wu=雾-霚-霧
xi=霫-霼
xia=霞
xian=霰
xiao=霄
xu=需
xue=雪
yang=雵-霷
yi=霬
yin=霠-霪
ying=霒-霙
yu=雨-雩-霱
yun=雲-霣
zha=霅
zhan=霑
zhao=雿
zhen=震
unknown=霗-霻-靍
