ban=頒
bin=顮
cheng=頙-頳
chui=顀
cui=顇
dan=頕
di=頔
dian=顚-顛
ding=頂-顁
dui=頧
dun=頓
e=頞-頟-額-顎
fu=頫
gu=頋-顧
gua=頢
han=頇-頷-顄
hang=頏
hao=顥
he=頜
hong=顭
hu=頶
hui=頮-顪
hun=顐
jia=頬-頰
jiang=顜
jie=頡
jing=頚-頸
jiong=顈
jun=頵
kan=顑
ke=頦-顆
ku=顝
kui=頍-頯
lai=頼-顂
lan=顲
le=頱
lei=頛-頪-類
liao=顟
ling=領
lu=顱
man=顢
nie=顳
pan=頄-頖
pian=頨
piao=顠
pin=頻-顰
ping=頩
po=頗
qi=頎-顣
qian=顅-顩
qiao=頝-顦
qin=顉
qing=頃
quan=顴
ru=顬
sai=顋
sang=顙
shen=頣
shun=順
song=頌
ti=題
ting=頲
tou=頭
tui=頹-頺-頽
wan=頑
wei=頠
xian=顕-顯
xiang=項
xin=顖
xu=須-頊
xun=顨
yan=顃-顏-顔
yao=顤
ye=頁
yi=頉-頤-頥-顊-顗-顡
ying=頴
yong=顒
yu=預
yuan=願
zhan=顫
zhuan=顓
zi=頾-頿
