ai=騃
ao=驁
bao=駂
bi=駜-驆
biao=驫
bin=驞
bo=駁-駊-駮-驋
can=驂
cao=騲
cheng=騁-騬
chi=馳
cong=騘-驄
dan=馾-駳
di=馰
dong=駧
du=騳
dun=驐
e=騀
er=駬
fei=騑-騛
feng=馮
fu=駙
gua=騧
hai=駭
han=馯-駻
hua=驊
huan=驩
huang=騜
huo=騞
ji=驥
jia=駕
jian=騝
jiao=驕
jie=騔
jing=驚
jiong=駉-駫
ju=駏-駒-駶-驧
jun=駿
ke=騍
kuai=駃
kui=騤-騩
kun=騉
lai=騋
li=騹-驪
liang=駺
lin=驎
ling=駖
liu=駠-駵-騮-驑
lu=騄-騼
lu:=馿-驢
luo=駱-騾-驘
ma=馬-駡
mang=駹
mo=驀
nu=駑
pang=騯
pei=馷
peng=駍-驡
pi=駓
pian=駢-騈-騗-騙
piao=驃
qi=騎-騏
qian=騚-騫
qin=駸
qu=駆-駈-驅
quan=駩-騡
ri=馹
rong=駥
rou=騥
sa=馺
sao=騒-騷
shan=騸
she=騇
shen=駪
shi=駛
shuang=騻-驦
si=駟-騦
song=駷
sou=騪
su=驌
tai=駘
tan=驔
tao=駣-騊
teng=駦-騰-驣
ti=騠
tie=驖
tu=駼
tui=駾
tuo=馱-馲-駄-駝-駞-騨-驒-驝
wen=馼-駇
wu=騖
xi=騱-騽-驨
xia=騢
xiang=驤
xiao=驍
xie=駴
xin=馸
xing=騂
xu=驉
xuan=駽
xun=馴-駨
yan=騐-験-騴-驗-驠
yang=駚
yao=騕
ye=驜
yi=駅-驛
yin=馻-駰
you=駀
yu=馭-騟-驈
yuan=駌-騵
zang=駔
zeng=驓
zhan=驏-驙
zhang=騿
zhao=駋
zhen=駗
zhi=馶-馽-駤-騭-騺-驇
zhou=駎-騆
zhu=馵-駐
zhui=騅
zong=騌-騣
zou=騶-驟
unknown=駯-駲
