biao=髟
bin=髩-鬂-鬓-鬢
dan=髧
duo=鬌
er=髵
fa=髪-髮
fang=髣
fu=髴
gua=髺
hu=鬍
huan=鬟
ji=髻
jian=鬋
jiu=鬏
kuai=鬠
kun=髠-髡-髨
la=鬎
li=鬁
lian=鬑
lie=鬛-鬣
man=鬗-鬘
mao=髦-髳
mo=鬕
ning=鬡
nong=鬞
pao=髱
peng=髼-鬅-鬔
pi=髬-髲
qi=鬐
qian=鬜-鬝
qu=髷
quan=鬈
ran=髥-髯
rang=鬤
rong=髶
san=鬖
seng=鬙
sha=髿
shao=髾
shun=鬊
song=鬆
ti=髢-髰-鬀-鬄
tiao=髫
xiu=髤-髹
xu=鬚
zhen=鬒
zheng=鬇
zhua=髽
zi=髭
zong=鬃-鬉
unknown=髸
